111111111111111111111111111111111
100000000000001000000000000000001
1000000C000C0010000C00000000P0001
100E000C0100000000000C00000100001
10000000010C000000000000000100001
111111111111111111111111111111111
