111111111111111111111111111111111
100000000000001000000000000000001
1000000C000C0010000C00000000P0001
100E000C0000001000000C00000000001
10000000000C000000000000000000001
111111111111111111111111111111111
