111111111111111111111111111111111
100000000000000000000000000000001
1000000CC000C0000C00C00E000000001
1000000C0000000000000C00P00000001
100000000000000000000000000000001
111111111111111111111111111111111
