111111111111111111111111111111111
10100E000000001000100000000000001
1000000C00000010001000000000P0001
110C0100010000000000C000000100001
10000100010000000000C000000100001
111111111111111111111111111111111
