111111111111111111111111111111111
1010000000000010000000000000000E1
1000000C000C0010000C00000000P0001
110000C00100000000000C00000100001
10000000010C000000000000000100001
111111111111111111111111111111111
