111111111111111111111111111111111
101000000000001000000000000000001
1000000C000C0010000C0E000000P0001
110000C00100000000000C00000100001
10000000010C000000000000000100001
111111111111111111111111111111111
