111111111111111111111111111111111
100000000000000000000000000000001
1000000C000C0000000C00000000P0001
100E000C0000000000000C00000000001
10000000000C000000000000000000001
111111111111111111111111111111111
