1111111
1P00XC1
1011101
1C00XE1
1111111
