111111111111111111111111111111111
10100E000X000010001000000X0000001
1000000C00000010001000000000P0001
110C010001000X000000C000000100001
1000010001000000000C000X000100001
111111111111111111111111111111111
