111111111111111111111111111111111
10100E000X000010001000000X0000001
1000000C00000010001000000000P0001
110C010001000X000000C000000100001
100010001000000000C000X0001000001
111111111111111111111111111111111
