111111111111111111111111
1E00X000C0001000000000P1
10000000000010000000X001
1000C0000C0000X0000C0001
111111111111111111111111