111111111111111111111111111111111
1C100C00000X00100010C000E00000C01
10000C000000001000100000000000P01
110C01000100000X000000X0000100001
1C0010001000X0000000X00000100C001
111111111111111111111111111111111
