111111111111111111111111111111111
1C100C0000C00010P0100X00E00C00X01
100C0000000000100010000X000000001
11000100010C000000C00000000100001
1C001000100000X00000C0X000100C001
111111111111111111111111111111111