1111111111111111111111111
100000000000      0000001
10P0000000CE      0000001
100000000000      0000001
1111111111111111111111111
