0111111111111111111111111
10000C00000000000C0000001
10P000001001000E000000001
100000X0001110000C0000001
1111111111111111111111111
