11111
1PCC1
1CCC1
1CCE1
11111
