11111
1XPX1
1CXC1
1CEC1
11111
