1111111111
1P0000C0E1
1011011101
1C0C000001
1111111111
