1111111111
1P1000C0E1
1111011101
1C0C000001
1111111111
